10
G.-.P_G.-.-.P.-.-.-.-
G.-.W.-.P.-.-.-.-.G
-.-.W.-.P.-.-.-.-.-
-.P.-.-.-.-.-.-.-.-
P.-.-.-.-.-.-.-.-.-
-.-.-.-.-.-.-.-.-.-
-.-.-.-.-.-.P.-.-.-
-.P_G.-.-.-.-.-.G.-.-
-.-.-.-.-.-.-.-.H_P.-
A.-.-.-.-.-.-.-.-.-